111111111111111111111111111111111111111111111111111111111111111111111
100000000000000000000000000000000000011111111111111111111111111111111
100000000C00000000000000000000000000000000000P00000000000000011111111
100000000000000000000000000000000000000000000000000000000000011111111
10000000000000000000C000000000000000000000000000000000000000011111111
111111111111111111111111100000000000000000000000000000000000011111111
100000000000000000000000000000000000000000111111111111111111111111111
100000000000E00000000000000000000000000000000000111111111111111111111
1C0000000000000000000000000000000000000000000000011111111111111111111
100000000000000000000000000000000000000000000000001111111111111111111
111100000001111111111111111111100000000000000000000011111111111111111
100000000000000001111111111111111111111111111111111111111111111111111
100000000C00000000000000000001111111111111111111111111111111111111111
100000000000000000000000000000000000000111111111111111111111111111111
111111111111111111110000000000000000000011111111111111111111111111111
111111111111111111111110000000000000000001111111111111111111111111111
111111111111111111111111111100000000000000001111111111111111111111111
111111111111111111111110000000000000000000000111111111111111111111111
111111111111111111100000000000000000000C00000111111111111111111111111
111111111111111111111111111110000000000000000001111111111111111111111
111111111111111111111111000000000000000000000000011111111111111111111
111111111111111111111000000000000000000000000000000111111111111111111
111111111111000000000000000C00000000000000000000000111111111111111111
111110000000000000000000000000000000000000000000000111111111111111111
100000000000000000000000000000000000000000000000000111111111111111111
100000000000000000000000000000000000000111111111111111111111111111111
100000000000000000000000000000000000011111111111111111111111111111111
100000000000000000000000000000000111111111111111111111111111111111111
100000000000000000000000000011111111111111111111111111111111111111111
111111111111111111111111111111111111111111111111111111111111111111111
