11111111111111111111111
1DDDDDDDDDDDCDDDDDDDDD1
1DDDDDDDDE000000000DDD1
1DDDDDDDDDDDD00DD0000D1
1DDD0000000000CD00PD001
11111111111111111111111
