1111111111111111111
100C0000E0000000001
1000110000000110001
10000000C0000001111
100C000000000000001
1000000111000000001
1P000000000000001C1
1111111111111111111
