111111111111111111111111111111111111
1110C0000000000000000000000000000111
111111110011111111111111111000000001
111111C00000000000000000000000111111
100000000000000000000000000000000001
111111100000000000000000000000000001
100000000000000000000011111111111111
10C0000000000000000000E0000000000001
100001111111111110000000000000000001
1111100000000000000P0000000001111111
10000000000000000C000000000000000011
111111111111111111111111111111111111
