11111111111111111111111111111111
100000000000000000000P1111111111
1110000000000C000000000000011111
111111E0000000000000000000001111
10000000000000000000000000000001
1C000000011111000000000000000001
11111110000000000000000000111111
1000C000000000000000000000001111
1111111111000000000000C000000001
11111111111111111111111111111111
