1111111111111111111
10000C0000000000001
111100000C000000011
100E000000000000001
11110D0C00000011111
1000DPD000000000001
1111111111111111111
