1111111
10P0001
1E00C01
11111111
