11111111111111111111111
1000D00000000C00000D001
111C000000000000000E001
1111100000C0D0011111111
1P000000000000000000001
1D000000000011111111111
10000C00000000000000001
11111111111111111111111
