111111111111111111111111111111111111
10000000000000000000000000000000P001
100000000000000000000000000000000001
1E0000000000000000000000000000000001
100000000000000000000000000111111111
111111111111111111111111111111111111
