111111111111111
1000D000C0000D1
111C0000000E001
111000C0D001111
1P0000000000001
10000C000000001
111111111111111
