111111111111111111111111111111111111
100000000000000000000000P0000000P001
100000000000000000000000000000000001
1E0000000000000000000000000000000001
1000000000000C00000000000000C1111111
111111111111111111111111111111111111
