1111111111111111111111111
1000000000P000000000C0001
1000000000000000000000000
100000E110000000000000001
1C000000000111C0000000001
1000000000000000000001111
1111111111111111111111111
