11111111111111
100P0000000001
1000000000C001
1000e00E000001
11111111111111
